date,V15943317,V15943318,V15943319,V15943320,V15943321,V15943316
08/07/1999,17384,4375,564,461,2942,25726
15/07/1999,17004,4467,535,463,2952,25421
23/07/1999,16934,4746,539,470,2998,25687
31/07/1999,16728,4845,540,474,3025,25612
08/08/1999,16692,4858,540,475,3030,25595
15/08/1999,16787,4877,550,495,3096,25805
23/08/1999,16949,4872,540,493,3111,25965
31/08/1999,16731,4883,495,493,3111,25713
08/09/1999,16783,4908,497,492,3108,25788
15/09/1999,16793,5053,499,495,3128,25968
23/09/1999,16820,5049,477,497,3139,25982
30/09/1999,16872,5114,540,499,3211,26236
08/10/1999,17130,5047,584,497,3201,26459
15/10/1999,17146,5174,570,502,3232,26624
23/10/1999,16866,5291,546,502,3229,26434
31/10/1999,17127,5410,540,496,3195,26768
08/11/1999,17407,5459,520,494,3183,27063
15/11/1999,17401,5435,525,512,3181,27054
23/11/1999,17392,5336,537,513,3184,26962
30/11/1999,19263,5428,526,510,3170,28897
08/12/1999,19415,5708,507,513,3189,29332
15/12/1999,19177,5712,506,524,3150,29069
23/12/1999,18851,5668,519,527,3172,28737
31/12/1999,18838,5594,524,526,3164,28646
08/01/2000,18932,5675,509,528,3086,28730
15/01/2000,19197,5847,511,527,3080,29162
23/01/2000,19380,5779,520,526,3075,29280
31/01/2000,19353,5600,466,519,3031,28969
08/02/2000,19918,5760,467,517,3016,29678
15/02/2000,19884,5747,479,540,3042,29692
23/02/2000,20112,5997,476,538,3056,30179
29/02/2000,20091,5773,457,534,3032,29887
08/03/2000,20061,5793,435,533,3030,29852
15/03/2000,20195,5958,432,536,3044,30165
23/03/2000,20501,6113,426,534,3032,30606
31/03/2000,21020,6089,411,537,3050,31107
08/04/2000,21485,6093,394,535,2742,31249
15/04/2000,21274,6116,396,534,2737,31057
23/04/2000,21102,6048,393,533,2731,30807
30/04/2000,21066,5839,387,526,2616,30434
08/05/2000,21006,5720,372,521,2589,30208
15/05/2000,21035,5798,368,522,2594,30317
23/05/2000,21512,5831,367,534,2562,30806
31/05/2000,19862,6100,364,545,2612,29483
08/06/2000,20035,6208,382,552,2756,29933
15/06/2000,20518,6235,384,550,2748,30435
23/06/2000,20414,6158,382,550,2746,30250
30/06/2000,20326,6277,358,553,2646,30160
08/07/2000,20453,6163,352,549,2649,30166
15/07/2000,20340,6117,349,545,2633,29984
23/07/2000,20517,6097,347,546,2634,30141
31/07/2000,20645,6173,344,543,2517,30222
08/08/2000,20636,6034,340,541,2611,30162
15/08/2000,20656,6089,341,560,2614,30260
23/08/2000,20903,6152,340,558,2604,30557
31/08/2000,21197,6159,328,557,2337,30578
08/09/2000,21331,6088,323,554,2425,30721
15/09/2000,21139,6035,323,550,2407,30454
23/09/2000,21152,6218,324,554,2426,30674
30/09/2000,21163,6331,324,554,2325,30697
08/10/2000,21246,6203,320,551,2416,30736
15/10/2000,21313,6133,323,552,2419,30740
23/10/2000,21336,6076,321,546,2394,30673
31/10/2000,21230,6163,313,546,2292,30544
08/11/2000,21286,6284,313,549,2362,30794
15/11/2000,21100,6293,313,572,2362,30640
23/11/2000,21095,6202,315,562,2344,30518
30/11/2000,21324,6613,319,565,2256,31077
08/12/2000,21584,6565,323,570,2249,31291
15/12/2000,21932,6790,320,571,2253,31866
23/12/2000,21879,7043,324,575,2270,32091
31/12/2000,21692,7327,323,574,2508,32424
08/01/2001,21898,7222,318,577,2522,32537
15/01/2001,21835,7295,312,576,2518,32536
23/01/2001,21929,7371,315,574,2589,32778
31/01/2001,21709,7663,313,572,2581,32838
08/02/2001,21818,7326,311,570,2490,32515
15/02/2001,21650,7234,306,590,2479,32259
23/02/2001,21502,7333,303,584,2449,32171
28/02/2001,21942,7608,310,587,2464,32911
08/03/2001,21858,7716,307,588,2467,32936
15/03/2001,21890,7466,305,581,2437,32679
23/03/2001,22642,7838,306,575,2413,33774
31/03/2001,22407,7829,300,573,2403,33512
08/04/2001,22341,8153,301,576,2418,33789
15/04/2001,22185,7491,302,575,2413,32966
23/04/2001,22190,8114,306,579,2430,33619
30/04/2001,21940,8018,306,575,2368,33207
08/05/2001,21951,8146,309,576,2279,33261
15/05/2001,21961,8152,310,573,2264,33260
23/05/2001,21932,8143,330,587,2411,33403
31/05/2001,21871,8085,311,586,2408,33261
08/06/2001,21974,8105,311,583,2396,33369
15/06/2001,21594,8211,317,587,2343,33052
23/06/2001,21550,8323,318,583,2258,33032
30/06/2001,21465,8401,315,582,2252,33015
08/07/2001,21485,8444,308,579,2240,33056
15/07/2001,21432,8513,310,583,2257,33095
23/07/2001,21297,8828,313,587,2272,33297
31/07/2001,21619,9012,309,588,2276,33804
08/08/2001,21414,9110,310,588,2513,33935
15/08/2001,21477,9589,320,615,2555,34556
23/08/2001,21698,9737,320,612,2557,34924
31/08/2001,21658,9874,312,615,2571,35030
08/09/2001,20548,9733,312,609,2544,33746
15/09/2001,20401,10197,326,616,2987,34527
23/09/2001,20338,10111,334,617,2968,34368
30/09/2001,20017,10187,335,616,3064,34219
08/10/2001,20184,10417,333,615,3060,34609
15/10/2001,20280,10359,322,612,3046,34619
23/10/2001,20238,10194,315,605,3010,34362
31/10/2001,20479,10520,308,610,3038,34955
08/11/2001,20226,10544,310,610,3035,34725
15/11/2001,20042,10306,305,622,2924,34199
23/11/2001,19840,10315,302,617,2916,33990
30/11/2001,20067,10670,305,619,2924,34585
08/12/2001,19905,10463,296,619,2922,34205
15/12/2001,19903,10809,300,621,2931,34564
23/12/2001,19784,10758,292,617,2891,34342
31/12/2001,19748,10736,291,614,2859,34248
08/01/2002,19620,10825,293,614,2810,34162
15/01/2002,19722,10746,299,616,2818,34201
23/01/2002,19288,10746,295,612,2800,33741
31/01/2002,19147,10767,297,607,2826,33644
08/02/2002,19045,10946,320,609,2926,33846
15/02/2002,19078,10973,315,623,2928,33917
23/02/2002,18967,11075,280,620,2926,33868
28/02/2002,19051,11308,284,619,2918,34180
08/03/2002,18878,11422,277,625,2905,34107
15/03/2002,18989,11674,278,626,2867,34434
23/03/2002,18904,11681,281,623,2854,34343
31/03/2002,18495,11679,288,621,2946,34029
08/04/2002,18583,11829,287,624,2959,34282
15/04/2002,18597,11926,272,624,2961,34380
23/04/2002,18648,12140,274,627,2974,34663
30/04/2002,18858,12393,266,632,2807,34956
08/05/2002,18653,12455,268,633,2789,34798
15/05/2002,18690,12513,266,645,2781,34895
23/05/2002,18821,12739,274,651,2813,35298
31/05/2002,19019,12889,281,655,2832,35676
08/06/2002,18862,12978,281,655,2834,35610
15/06/2002,19098,13101,278,657,2842,35976
23/06/2002,18828,13460,278,663,3363,36592
30/06/2002,19078,13753,274,675,3410,37190
08/07/2002,19176,13634,269,672,3393,37144
15/07/2002,18187,13955,275,678,3425,36520
23/07/2002,18319,13759,275,676,3406,36435
31/07/2002,18512,13678,262,671,3287,36410
08/08/2002,18496,13632,269,666,3263,36326
15/08/2002,18468,13856,269,671,3387,36651
23/08/2002,18598,13710,264,681,3365,36618
31/08/2002,18836,13931,242,688,3399,37096
08/09/2002,17742,13770,247,690,3408,35857
15/09/2002,17904,13611,247,686,3389,35837
23/09/2002,18226,13748,249,684,3309,36216
30/09/2002,18426,13937,250,686,3316,36615
08/10/2002,18586,13698,247,683,3303,36517
15/10/2002,18611,13579,245,683,3302,36420
23/10/2002,18909,13537,241,681,3295,36663
31/10/2002,19234,13811,216,685,3310,37256
08/11/2002,18869,14149,220,693,3295,37226
15/11/2002,18546,14052,218,707,3284,36807
23/11/2002,18376,13923,217,700,3279,36495
30/11/2002,18419,13902,218,697,3265,36501
08/12/2002,18426,14083,222,697,3268,36696
15/12/2002,18696,14360,227,706,3360,37349
23/12/2002,17853,14345,206,709,3566,36679
31/12/2002,17946,14739,205,712,3567,37169
08/01/2003,17735,14733,210,715,3562,36955
15/01/2003,17789,14825,210,719,3560,37103
23/01/2003,17936,15194,218,726,3580,37654
31/01/2003,17885,15211,220,728,3591,37635
08/02/2003,17954,15283,224,725,3576,37762
15/02/2003,17870,15282,212,739,3575,37678
23/02/2003,15855,15281,211,739,3582,35668
28/02/2003,16188,15238,177,738,3560,35901
08/03/2003,16348,15300,178,745,3594,36165
15/03/2003,16397,14549,170,737,3557,35410
23/03/2003,16260,14063,170,729,3742,34964
31/03/2003,16501,14754,170,739,3762,35926
08/04/2003,16427,14394,164,732,3723,35440
15/04/2003,16386,14512,138,734,3737,35507
23/04/2003,16515,14744,141,739,3741,35880
30/04/2003,16587,15045,142,745,3744,36263
08/05/2003,16732,15564,146,753,3773,36968
15/05/2003,16634,15476,150,769,3760,36789
23/05/2003,16609,16156,157,777,3798,37497
31/05/2003,16652,16044,153,777,3797,37423
08/06/2003,16477,15776,153,778,3804,36988
15/06/2003,16725,16119,149,777,3799,37569
23/06/2003,16293,15592,150,771,4177,36983
30/06/2003,16207,15469,107,766,4150,36699
08/07/2003,16320,15069,107,763,4134,36393
15/07/2003,16236,14902,108,764,4136,36146
23/07/2003,16057,15235,110,764,4111,36277
31/07/2003,15967,14831,110,761,4096,35765
08/08/2003,15927,14999,109,763,4106,35904
15/08/2003,16094,14818,113,773,3822,35620
23/08/2003,16092,14395,111,764,3779,35141
31/08/2003,16134,14541,65,765,3785,35290
08/09/2003,16046,14493,65,770,3801,35175
15/09/2003,16314,14798,65,774,3870,35821
23/09/2003,16186,15115,67,788,3938,36094
30/09/2003,16382,15464,67,794,3971,36678
08/10/2003,16224,15243,65,797,3983,36312
15/10/2003,16253,14939,65,795,3975,36027
23/10/2003,16200,15137,67,798,3991,36193
31/10/2003,16145,14902,67,795,3947,35856
08/11/2003,15942,14765,66,788,3910,35471
15/11/2003,15990,15167,69,812,3969,36007
23/11/2003,15936,15370,68,814,3978,36166
30/11/2003,15879,15365,69,812,3968,36093
08/12/2003,15279,15488,70,825,3934,35596
15/12/2003,15312,15637,44,825,3934,35752
23/12/2003,15417,15774,45,832,3966,36034
31/12/2003,15576,15961,45,838,3848,36268
08/01/2004,15597,16287,46,840,3856,36626
15/01/2004,15680,16095,45,842,3864,36526
23/01/2004,15656,16162,45,846,3883,36592
31/01/2004,15684,15967,44,835,3836,36366
08/02/2004,15243,16016,44,839,3852,35994
15/02/2004,15321,16100,45,864,3906,36236
23/02/2004,15698,15857,44,852,3705,36156
29/02/2004,15546,15840,43,847,3705,36083
08/03/2004,15716,15736,44,843,3586,35925
15/03/2004,16193,15605,43,840,3571,36252
23/03/2004,16148,15714,45,846,3598,36351
31/03/2004,16194,15723,46,847,3602,36412
08/04/2004,16175,15350,46,843,3586,36000
15/04/2004,15723,15160,43,831,3534,35291
23/04/2004,15582,14989,43,830,3532,34976
30/04/2004,15712,15112,42,832,3415,35113
08/05/2004,15713,14930,42,834,3423,34942
15/05/2004,15951,14898,41,832,3367,35089
23/05/2004,16045,15057,42,842,3404,35390
31/05/2004,16356,15315,43,851,3411,35978
08/06/2004,15937,14581,43,854,3400,34815
15/06/2004,16112,14469,42,844,3361,34828
23/06/2004,16346,14391,43,848,3374,35002
30/06/2004,16644,14545,43,849,3335,35418
08/07/2004,16751,14701,44,856,3362,35714
15/07/2004,16817,14634,44,856,3361,35712
23/07/2004,16809,14371,43,850,3287,35360
31/07/2004,16744,14299,43,845,3267,35281
08/08/2004,16910,14702,43,845,3267,35767
15/08/2004,16932,14793,43,859,3280,35907
23/08/2004,16945,14467,45,863,3293,35613
31/08/2004,17018,14623,44,857,3345,35891
08/09/2004,17133,14273,43,855,3336,35640
15/09/2004,17338,14270,44,860,3356,35868
23/09/2004,17590,14457,45,862,3293,36247
30/09/2004,17522,14633,45,862,3198,36265
08/10/2004,17288,14472,46,861,3194,35861
15/10/2004,17287,14583,46,865,3209,35990
23/10/2004,17299,14844,46,875,3243,36307
31/10/2004,17267,15001,46,880,3262,36460
08/11/2004,17143,15125,47,887,3287,36489
15/11/2004,17141,15215,48,899,3286,36589
23/11/2004,17086,15404,49,905,3311,36755
30/11/2004,14113,15663,49,912,3334,34071
08/12/2004,14289,15510,48,914,3389,34150
15/12/2004,14405,15619,48,915,3394,34381
23/12/2004,14426,15715,48,917,3313,34419
31/12/2004,14427,15740,48,925,3327,34467
08/01/2005,14458,15208,46,908,3280,33900
15/01/2005,14702,15327,46,907,3276,34258
23/01/2005,14827,15259,46,908,3265,34305
31/01/2005,15138,15246,46,905,3255,34590
08/02/2005,15442,14952,45,894,3236,34569
15/02/2005,15511,15234,46,915,3266,34972
23/02/2005,15848,15390,47,923,3225,35433
28/02/2005,15947,15434,47,925,3208,35561
08/03/2005,15413,15445,48,925,3206,35037
15/03/2005,15507,15430,48,929,3219,35133
23/03/2005,15823,15007,46,916,3175,34967
31/03/2005,17080,15043,47,916,3164,36250
08/04/2005,16089,15032,46,907,3143,35217
15/04/2005,16082,15067,46,908,3147,35250
23/04/2005,16259,15265,47,918,3182,35671
30/04/2005,16419,15045,47,916,3176,35602
08/05/2005,16678,14982,46,916,2836,35458
15/05/2005,16675,14780,46,901,2870,35272
23/05/2005,16789,14700,46,914,2848,35297
31/05/2005,16785,14483,45,904,2817,35034
08/06/2005,16685,14332,46,907,2825,34795
15/06/2005,16533,14143,47,895,2788,34406
23/06/2005,16908,14131,48,898,2503,34488
30/06/2005,17303,14196,48,893,2484,34924
08/07/2005,17265,13881,46,884,2459,34535
15/07/2005,17439,13945,46,891,2466,34787
23/07/2005,16381,13997,46,892,2107,33423
31/07/2005,16241,14050,47,890,2101,33328
08/08/2005,16199,14261,48,900,2125,33533
15/08/2005,16207,14343,48,915,2133,33646
23/08/2005,16301,14223,48,910,2121,33603
31/08/2005,16878,14354,47,907,2113,34299
08/09/2005,16690,13688,49,917,2136,33480
15/09/2005,16660,13690,50,911,2122,33433
23/09/2005,16687,13705,50,905,2109,33456
30/09/2005,16725,13824,52,900,2098,33599
08/10/2005,16752,13931,52,903,2104,33742
15/10/2005,16682,13960,51,896,2088,33677
23/10/2005,16758,14026,50,898,2142,33874
31/10/2005,16909,14214,51,898,2142,34214
08/11/2005,16922,14057,50,885,2141,33955
15/11/2005,16876,14183,51,891,2033,34034
23/11/2005,16666,14586,53,894,2040,34239
30/11/2005,16646,14566,54,894,2039,34199
08/12/2005,15587,13459,56,894,2040,32036
15/12/2005,15706,13849,55,906,2149,32665
23/12/2005,16819,13831,55,899,1404,33008
31/12/2005,16842,13822,56,897,1401,33018
08/01/2006,16619,14623,58,907,1041,33248
15/01/2006,16971,14208,60,908,1042,33189
23/01/2006,16965,14354,60,915,1050,33344
31/01/2006,16813,14135,62,907,1042,32959
08/02/2006,16770,13910,60,899,1035,32674
15/02/2006,16690,13850,59,907,1033,32539
23/02/2006,16690,13897,60,910,1036,32593
28/02/2006,16707,13974,61,908,1034,32684
08/03/2006,16640,13497,59,907,1033,32136
15/03/2006,16693,13724,61,911,1037,32426
23/03/2006,17792,13392,60,912,1038,33194
31/03/2006,20204,13812,63,917,1038,36034
08/04/2006,20140,13778,64,915,1042,35939
15/04/2006,20075,14027,65,912,1039,36118
23/04/2006,20001,14523,68,920,1048,36560
30/04/2006,18660,14997,70,931,1058,35716
08/05/2006,18466,15194,74,942,1071,35747
15/05/2006,18448,15546,75,948,1103,36120
23/05/2006,18224,15685,73,949,1103,36034
31/05/2006,17846,15715,71,949,1103,35685
08/06/2006,17676,15369,67,942,1096,35150
15/06/2006,17623,15230,62,937,1090,35032
23/06/2006,17599,15443,63,933,1085,35123
30/06/2006,17671,16143,67,939,1092,35916
08/07/2006,17688,16044,69,941,1094,35836
15/07/2006,17740,16028,72,938,1090,35868
23/07/2006,17707,16326,69,939,1091,36132
31/07/2006,17712,16572,69,942,1096,36395
08/08/2006,17895,16678,70,947,1101,36691
15/08/2006,17921,16553,68,945,1094,36581
23/08/2006,17939,16663,68,948,1097,36715
31/08/2006,17010,16727,68,949,1099,35853
08/09/2006,16712,16573,66,944,1093,35388
15/09/2006,16814,16947,63,943,1092,35859
23/09/2006,16624,17326,64,949,1098,36061
30/09/2006,16755,17166,65,941,1090,36017
08/10/2006,16545,16863,61,942,1091,35502
15/10/2006,16578,16712,64,936,971,35261
23/10/2006,16429,17050,64,937,938,35418
31/10/2006,16256,17432,66,944,945,35643
08/11/2006,16171,17408,68,947,898,35492
15/11/2006,16387,17526,67,949,896,35825
23/11/2006,16456,17702,69,953,900,36080
30/11/2006,16423,18152,70,965,867,36477
08/12/2006,15965,17726,69,968,837,35565
15/12/2006,15614,17520,68,962,831,34995
23/12/2006,15627,17530,68,964,833,35022
31/12/2006,15608,17590,69,963,833,35063
08/01/2007,15662,17395,66,957,828,34908
15/01/2007,15954,17257,68,954,825,35058
23/01/2007,16206,17387,70,959,829,35451
31/01/2007,16679,17379,71,954,825,35908
08/02/2007,16798,17425,72,957,715,35967
15/02/2007,16742,17590,72,963,718,36085
23/02/2007,16652,17615,74,961,717,36019
28/02/2007,16771,17781,72,966,720,36310
08/03/2007,17094,17612,71,964,719,36460
15/03/2007,19051,17760,71,966,720,38568
23/03/2007,19358,17920,72,970,723,39043
31/03/2007,19548,17991,72,976,722,39309
08/04/2007,19629,18051,73,971,724,39448
15/04/2007,19886,18131,74,977,728,39796
23/04/2007,20002,18378,75,978,714,40147
30/04/2007,19982,18435,74,978,714,40183
08/05/2007,19913,18285,75,976,697,39946
15/05/2007,19757,18436,73,975,969,39937
23/05/2007,19888,18227,72,972,694,39853
31/05/2007,20088,18271,72,972,693,40096
08/06/2007,19033,17745,71,969,691,38509
15/06/2007,19073,17914,71,967,690,38715
23/06/2007,19172,18047,71,971,693,38954
29/06/2007,19487,18186,71,974,695,39413
08/07/2007,19545,18249,71,977,697,39539
15/07/2007,19567,18380,73,983,702,39705
23/07/2007,19723,18573,74,987,687,40044
31/07/2007,20067,18494,73,984,685,40303
08/08/2007,19948,18614,74,985,687,40308
15/08/2007,19657,18280,73,978,656,39644
23/08/2007,19912,18490,72,982,658,40114
31/08/2007,19989,18594,73,985,660,40301
08/09/2007,20033,18877,76,987,661,40634
15/09/2007,19726,19052,78,992,665,40513
23/09/2007,19534,19269,80,996,668,40547
28/09/2007,19452,19777,81,1001,671,40982
08/10/2007,19208,19244,80,998,669,40199
15/10/2007,19100,19278,83,1000,671,40132
23/10/2007,19329,19524,83,1002,672,40610
31/10/2007,19218,19806,86,1010,677,40797
08/11/2007,19096,20167,92,1019,683,41057
15/11/2007,18968,20118,87,1017,682,40872
23/11/2007,19053,20490,89,1025,687,41344
30/11/2007,18914,20146,85,1022,685,40852
08/12/2007,19029,20173,86,1016,681,40985
15/12/2007,19060,19779,86,1011,677,40613
23/12/2007,19180,19712,88,1005,654,40639
31/12/2007,19257,20057,91,1015,661,41081
08/01/2008,19438,20374,95,1017,662,41586
15/01/2008,19548,20495,100,1022,665,41830
23/01/2008,19855,20405,97,1016,661,42034
31/01/2008,19804,20662,101,1026,668,42261
08/02/2008,19814,20379,100,1011,658,41962
15/02/2008,19801,20767,99,1017,642,42326
23/02/2008,19785,21179,103,1022,646,42735
29/02/2008,20013,21805,106,1035,654,43613
08/03/2008,19440,21794,106,1046,661,43047
15/03/2008,19378,22297,109,1052,664,43500
23/03/2008,19149,21873,101,1047,662,42832
31/03/2008,18896,22329,102,1062,668,43057
08/04/2008,19139,22178,100,1051,664,43132
15/04/2008,19532,22333,101,1055,667,43688
23/04/2008,19623,22318,98,1057,668,43764
30/04/2008,19892,21912,95,1044,659,43602
08/05/2008,19682,21683,96,1037,649,43147
15/05/2008,19830,21680,96,1040,777,43423
23/05/2008,20091,22089,101,1050,784,44115
30/05/2008,19919,21763,97,1042,767,43588
08/06/2008,19211,21308,97,1042,767,42425
15/06/2008,19157,20913,94,1032,760,41956
23/06/2008,19781,21395,96,1039,765,43076
30/06/2008,19964,21967,101,1050,773,43855
08/07/2008,20301,18684,100,1045,769,40899
15/07/2008,21214,19130,107,1058,779,42288
23/07/2008,21303,18733,101,1047,768,41952
31/07/2008,21767,18988,100,1042,762,42659
08/08/2008,21823,18427,93,1022,749,42114
15/08/2008,22028,18198,86,1009,738,42059
23/08/2008,22160,18550,90,1014,741,42555
29/08/2008,22305,18450,91,1010,738,42594
08/09/2008,22493,17894,88,993,726,42194
15/09/2008,23003,18313,84,997,704,43101
23/09/2008,22805,18577,98,1017,718,43215
30/09/2008,22987,18130,96,1002,765,42980
08/10/2008,22972,17390,98,986,752,42198
15/10/2008,22476,17070,92,986,753,41377
23/10/2008,23137,16566,78,960,733,41474
31/10/2008,23316,16318,80,957,731,41402
08/11/2008,20996,16474,80,955,1205,39710
15/11/2008,21558,16625,81,950,1198,40412
23/11/2008,21998,16581,84,950,1198,40811
28/11/2008,22389,16913,89,962,1212,41565
08/12/2008,22509,17245,84,960,1209,42007
15/12/2008,22580,18231,90,980,1235,43116
23/12/2008,22826,18733,92,993,1252,43896
31/12/2008,22804,18733,95,991,1249,43872
08/01/2009,22902,18410,93,982,1237,43624
15/01/2009,23266,17821,88,972,1331,43478
23/01/2009,23231,17463,95,958,1311,43058
30/01/2009,23133,17226,100,960,1310,42729
08/02/2009,22884,17397,100,960,1309,42650
15/02/2009,23327,17478,102,961,1309,43177
23/02/2009,23313,17355,107,957,1303,43035
27/02/2009,23384,17471,104,946,1288,43193
08/03/2009,22680,17378,102,947,1291,42398
15/03/2009,22910,17772,101,950,1263,42996
23/03/2009,22903,18470,103,975,1296,43747
31/03/2009,22871,18039,100,964,1550,43524
08/04/2009,23119,17898,96,962,1547,43622
15/04/2009,23337,17971,97,965,1552,43922
23/04/2009,23605,18103,98,957,1540,44303
30/04/2009,23080,16931,96,965,1552,42624
08/05/2009,23674,17476,99,968,1557,43774
15/05/2009,24047,17788,101,979,1574,44489
23/05/2009,23978,18401,105,996,1601,45081
29/05/2009,23617,18543,106,999,1605,44870
08/06/2009,22697,17888,103,986,1584,43258
15/06/2009,22649,18063,102,990,1591,43395
23/06/2009,23277,18492,100,996,1600,44465
30/06/2009,23228,18520,102,1001,1811,44662
08/07/2009,23670,18448,100,995,1800,45013
15/07/2009,23291,18677,102,1002,1813,44885
23/07/2009,23363,18731,104,1005,1818,45021
31/07/2009,23335,18963,102,1002,2012,45414
08/08/2009,23088,18685,104,1010,1826,44713
15/08/2009,23156,19284,104,1007,1820,45371
23/08/2009,22756,19596,104,1011,2079,45546
31/08/2009,23076,19893,104,8405,2093,53571
08/09/2009,22808,20122,109,8451,2104,53594
15/09/2009,25438,20381,109,9260,2114,57302
23/09/2009,25642,20435,110,9294,2455,57936
30/09/2009,25942,20385,109,9276,2450,58162
08/10/2009,25362,19321,114,9314,2460,56571
15/10/2009,25129,19383,115,9338,2466,56431
23/10/2009,24674,19449,116,9385,2470,56094
30/10/2009,25119,19204,113,9341,2459,56236
08/11/2009,24911,19295,120,9369,2466,56161
15/11/2009,24692,19454,120,9396,2472,56134
23/11/2009,24198,19578,127,9422,2478,55803
30/11/2009,24600,19741,128,9461,2490,56420
08/12/2009,24251,19339,125,9361,2464,55540
15/12/2009,24229,19072,122,9289,2445,55157
23/12/2009,23974,18783,118,9171,2413,54459
31/12/2009,23879,18723,119,9212,2424,54357
08/01/2010,23684,18886,123,9168,2413,54274
15/01/2010,23670,21823,123,9233,2430,57279
23/01/2010,23894,21467,118,9172,2414,57065
29/01/2010,24234,21090,118,9132,2403,56977
08/02/2010,24282,20859,116,9041,2380,56678
15/02/2010,24130,20756,120,9006,2370,56382
23/02/2010,24609,20643,121,8988,2365,56726
26/02/2010,24923,20922,121,9006,2370,57342
08/03/2010,24668,20509,123,9000,2368,56668
15/03/2010,24809,20579,120,9010,2371,56889
23/03/2010,24941,20412,120,8955,2431,56859
31/03/2010,24800,20400,122,8925,2422,56669
08/04/2010,24735,20189,125,8894,2414,56357
15/04/2010,25113,20525,126,8954,2431,57149
23/04/2010,25091,20237,124,8890,2413,56755
30/04/2010,25239,20200,129,8880,2395,56843
08/05/2010,25426,19462,131,8746,2325,56090
15/05/2010,25672,19098,135,8658,2493,56056
21/05/2010,25620,19412,129,8692,2503,56356
31/05/2010,25752,18984,132,8664,2495,56027
08/06/2010,26005,17056,136,8534,2457,54188
15/06/2010,26065,17564,134,8632,2503,54898
23/06/2010,26446,17529,134,8664,2512,55285
30/06/2010,26572,17473,136,8692,2520,55393
08/07/2010,26539,18127,130,8792,2549,56137
15/07/2010,26565,18473,132,8845,2565,56580
23/07/2010,26503,18334,130,8892,2578,56437
30/07/2010,27072,18539,127,8925,2648,57311
08/08/2010,27291,19040,132,8987,2667,58117
15/08/2010,27488,18431,132,8888,2637,57576
23/08/2010,27516,18375,134,8871,2632,57528
31/08/2010,27796,18492,136,8869,2632,57925
08/09/2010,27633,18442,137,8888,2637,57737
15/09/2010,27595,18751,138,8932,2650,58066
23/09/2010,27842,19228,141,9042,2683,58936
30/09/2010,27871,19672,142,9147,2714,59546
08/10/2010,27929,19360,146,9215,2734,59384
15/10/2010,27737,19396,149,9291,2757,59330
23/10/2010,27665,19190,144,9232,2739,58970
29/10/2010,27584,19160,147,9239,2818,58948
08/11/2010,27594,19248,151,9255,2823,59071
15/11/2010,27230,18647,149,9154,2791,57971
23/11/2010,27125,18372,150,9125,2782,57554
30/11/2010,26989,17726,151,8970,2735,56571
08/12/2010,26750,17930,151,9032,2754,56617
15/12/2010,26429,17849,151,9049,2759,56237
23/12/2010,26632,17829,150,8992,3035,56638
31/12/2010,26677,18211,153,9054,3056,57151
08/01/2011,26630,17603,149,8965,3026,56373
15/01/2011,26824,18001,149,9095,3283,57352
23/01/2011,26835,18190,146,9140,3439,57750
31/01/2011,27623,18295,145,9183,3461,58707
08/02/2011,27922,18187,149,9197,3574,59029
15/02/2011,28025,17990,150,9151,3555,58871
23/02/2011,28570,18436,154,9217,3581,59958
28/02/2011,28840,18494,154,9250,3594,60332
08/03/2011,28696,18486,155,9264,3599,60200
15/03/2011,28825,18799,153,9255,3596,60628
23/03/2011,28629,18855,157,9340,3767,60748
31/03/2011,28622,18737,157,9330,3760,60606
08/04/2011,28604,19055,160,9366,3777,60962
15/04/2011,29349,19093,161,9397,3790,61790
23/04/2011,29562,19309,164,9464,3817,62316
29/04/2011,29806,19669,167,9532,3844,63018
08/05/2011,30078,19121,162,9456,3813,62630
15/05/2011,30373,19139,164,9381,3782,62839
23/05/2011,30435,19349,163,9360,3773,63080
31/05/2011,30818,19804,167,9417,3796,64002
08/06/2011,30041,19050,168,9482,3825,62566
15/06/2011,30145,18640,167,9383,3785,62120
23/06/2011,30311,18810,166,9348,3771,62406
30/06/2011,30133,18978,164,9415,3798,62488
08/07/2011,30301,18819,168,9351,3773,64412
15/07/2011,30584,18695,173,9355,3774,62581
23/07/2011,30487,18820,175,9439,3808,62729
29/07/2011,30832,19027,178,9406,3795,63238
08/08/2011,31333,19030,185,9421,3801,63770
15/08/2011,31428,19391,190,9436,3805,64250
23/08/2011,31471,19618,205,9495,3829,64618
31/08/2011,31338,19667,198,9471,3819,64493
08/09/2011,31601,18837,202,9347,3769,63756
15/09/2011,31351,19101,194,9287,3745,63678
23/09/2011,31650,19062,184,9176,3700,63772
30/09/2011,31625,18973,177,9190,3753,63718
08/10/2011,31543,19082,180,9172,3746,63723
15/10/2011,31406,19828,183,9272,3787,64476
23/10/2011,31384,20320,179,9262,3785,64930
31/10/2011,31627,20476,188,9326,3811,65428
08/11/2011,31914,21320,196,9198,3786,66414
15/11/2011,32087,20713,195,9145,3831,65971
23/11/2011,32495,19983,183,9088,3807,65556
30/11/2011,32527,20166,190,9061,3796,65740
08/12/2011,32960,20209,187,9093,3809,66258
15/12/2011,32920,19918,172,8974,3759,65743
23/12/2011,32775,19983,175,9004,3891,65828
30/12/2011,32826,19985,167,8966,3875,65819
08/01/2012,32997,19560,176,8936,3862,65531
15/01/2012,33212,19568,178,8927,3858,65743
23/01/2012,32943,19955,183,8989,3887,65957
31/01/2012,33048,20170,190,9053,3915,66376
08/02/2012,32823,20351,190,9078,3926,66368
15/02/2012,35822,20177,189,9014,3898,69100
23/02/2012,35812,20629,194,9034,3906,69575
29/02/2012,35806,20618,193,9083,4095,69795
08/03/2012,35841,20587,184,9011,4063,69686
15/03/2012,35446,20170,180,8939,4030,68765
23/03/2012,35338,20457,181,9000,4075,69051
31/03/2012,35399,20633,181,9043,4094,69350
08/04/2012,35470,20264,178,8966,4060,68938
15/04/2012,35389,20344,182,9005,4138,69058
23/04/2012,35410,20284,178,9005,4139,69016
30/04/2012,35689,20468,180,9048,4159,69544
08/05/2012,35827,20233,175,8759,4135,69129
15/05/2012,35973,19839,170,8711,4112,68805
23/05/2012,36033,19701,169,8651,4084,68638
31/05/2012,36397,19500,170,8581,4051,68699
08/06/2012,34707,18380,172,8584,4056,65899
15/06/2012,34865,18552,177,8635,4154,66383
23/06/2012,34657,18336,171,8606,4140,65910
29/06/2012,34784,18489,174,8623,4148,66218
08/07/2012,34898,18211,173,8566,4120,65968
15/07/2012,34853,18216,174,8524,4101,65868
23/07/2012,35104,18026,171,8526,4101,65928
31/07/2012,35169,18275,177,8570,4130,66321
08/08/2012,35261,18306,176,8584,4137,66464
15/08/2012,35127,18131,175,8564,4126,66123
23/08/2012,35239,18614,182,8644,4165,66844
31/08/2012,35524,18662,180,8649,4167,67182
08/09/2012,35499,18914,188,8676,4180,67457
15/09/2012,35654,19265,194,8804,4242,68159
23/09/2012,35644,19137,195,8782,4232,67990
28/09/2012,35851,19017,194,8764,4315,68141
08/10/2012,35830,19245,194,8775,4321,68365
15/10/2012,35894,19183,189,8752,4310,68328
23/10/2012,35409,19132,187,8746,4306,67780
31/10/2012,35619,19182,187,8754,4311,68053
08/11/2012,35965,18954,187,8681,4263,68050
15/11/2012,36009,19010,186,8666,4256,68127
23/11/2012,35825,19193,189,8669,4257,68133
30/11/2012,35746,19283,188,8722,4283,68222
08/12/2012,35666,19254,185,8705,4274,68084
15/12/2012,35667,19563,185,8735,4289,68439
23/12/2012,35607,19585,180,8766,4383,68521
31/12/2012,35622,19621,181,8754,4368,68546
08/01/2013,35599,19335,181,8727,4354,68196
15/01/2013,35702,19549,183,8770,4375,68579
23/01/2013,35759,19435,184,8755,4480,68613
31/01/2013,35772,19668,179,8779,4492,68890
08/02/2013,35838,19438,180,8732,4468,68656
15/02/2013,36219,19411,174,8695,4433,68932
23/02/2013,36898,19220,170,8636,4403,69327
28/02/2013,37049,19115,166,8629,4399,69358
08/03/2013,36846,19002,165,8589,4379,68981
15/03/2013,37509,19140,166,8583,4375,69773
23/03/2013,37974,18978,168,8568,4368,70056
31/03/2013,38253,18860,165,8534,4396,70208
08/04/2013,38451,19187,162,8564,4412,70776
15/04/2013,38693,19228,144,8586,4423,71074
23/04/2013,38875,19008,145,8551,4405,70984
30/04/2013,39200,19286,150,8594,4405,71635
08/05/2013,39190,19251,150,8560,4431,71582
15/05/2013,39017,18785,144,8451,4374,70771
23/05/2013,38878,18848,141,8458,4378,70703
31/05/2013,38787,18868,142,8499,4399,70695
08/06/2013,37517,18032,141,8619,4543,68852
15/06/2013,37885,18243,142,8644,4574,69488
23/06/2013,37693,17760,132,8589,4545,68719
28/06/2013,38090,17634,121,8528,4513,68886
08/07/2013,37945,17515,125,8442,4467,68494
15/07/2013,38160,17949,130,8490,4462,69191
23/07/2013,38475,17734,135,8545,4491,69380
31/07/2013,38392,18066,133,8571,4595,69757
08/08/2013,38849,18166,132,8625,4624,70396
15/08/2013,38743,18022,135,8600,4610,70110
23/08/2013,38592,18111,140,8613,4617,70073
30/08/2013,38667,17938,139,8583,4601,69928
08/09/2013,38483,17964,138,8545,4590,69720
15/09/2013,38771,18160,132,8605,4622,70290
23/09/2013,38983,18529,132,8679,4662,70985
30/09/2013,39190,18656,130,8641,4775,71392
08/10/2013,39272,18704,130,8659,4785,71550
15/10/2013,39002,18574,125,8618,4763,71082
23/10/2013,39161,19023,131,8701,4808,71824
31/10/2013,39152,18821,130,8663,4731,71497
08/11/2013,39085,18490,126,8614,4704,71019
15/11/2013,39341,18701,126,8607,4700,71475
23/11/2013,39728,18744,122,8624,4590,71808
29/11/2013,39852,18813,122,8648,4603,72038
08/12/2013,39617,18884,120,8665,4612,71898
15/12/2013,39651,18930,120,8663,4611,71975
23/12/2013,39581,18838,117,8657,4707,71900
31/12/2013,39514,18916,115,8675,4717,71937
08/01/2014,39478,18672,117,8632,4693,71592
15/01/2014,39482,18924,119,8643,4699,71867
23/01/2014,39646,19100,121,8657,4707,72231
31/01/2014,40411,18917,120,8642,4688,72778
08/02/2014,40723,19125,121,8640,4687,73296
15/02/2014,41084,19201,127,8699,4593,73704
23/02/2014,40938,19322,127,8692,4589,73668
28/02/2014,44297,19424,127,8718,4603,77169
08/03/2014,44196,19502,128,8742,4616,77184
15/03/2014,44180,19622,133,8737,4613,77285
23/03/2014,43313,19350,128,8704,4596,76091
31/03/2014,43452,19554,124,8709,4611,76450
08/04/2014,43450,19603,126,8708,4611,76498
15/04/2014,43828,19676,124,8721,4618,76967
23/04/2014,43619,19985,123,8735,4626,77088
30/04/2014,43711,20107,124,8730,4623,77295
08/05/2014,44090,20100,123,8771,4684,77768
15/05/2014,44433,20000,125,8690,4571,77819
23/05/2014,44532,19847,124,8686,4569,77758
30/05/2014,44645,19875,120,8680,4565,77885
08/06/2014,42904,18407,120,8685,4668,74784
13/06/2014,42978,18266,122,8674,4662,74702
23/06/2014,42945,18926,126,8691,4671,75359
30/06/2014,43063,19347,126,8710,4628,75874
08/07/2014,42991,19369,127,8699,4622,75808
15/07/2014,43255,19314,126,8705,4626,76026
23/07/2014,43233,19107,125,8668,4606,75739
31/07/2014,43148,19002,123,8628,4565,75466
08/08/2014,43594,19206,126,8631,4567,76124
15/08/2014,43959,19228,124,8616,4559,76486
23/08/2014,43811,18737,122,8576,4538,75784
29/08/2014,43755,18652,123,8557,4527,75614
08/09/2014,43784,18314,121,8461,4489,75169
15/09/2014,41425,18903,118,8451,4347,73244
23/09/2014,41417,19153,117,8444,4343,73474
30/09/2014,41830,19089,117,8354,4297,73687
08/10/2014,41911,19265,117,8372,4307,73972
15/10/2014,41939,19384,119,8364,4303,74109
23/10/2014,42098,19101,118,8374,4307,73998
31/10/2014,42299,18946,112,8330,4225,73912
08/11/2014,42611,18840,111,8255,4187,74004
15/11/2014,42560,18928,112,8250,4185,74035
23/11/2014,42539,18818,115,8239,4179,73890
28/11/2014,42533,19029,113,8251,4185,74111
08/12/2014,42703,18960,114,8183,4150,74110
15/12/2014,43555,19435,116,8235,3622,74963
23/12/2014,43659,19051,113,8174,3669,74666
31/12/2014,43756,19000,116,8164,3664,74700
08/01/2015,44046,18537,117,8037,3607,74344
15/01/2015,44441,18473,121,8044,3611,74690
23/01/2015,44561,18001,124,7896,3544,74126
30/01/2015,44915,18413,121,7944,3444,74837
08/02/2015,45086,18532,119,7983,3198,74918
15/02/2015,44945,18795,118,7973,3194,75025
23/02/2015,44822,18697,116,7946,3183,74764
27/02/2015,45039,18511,116,7927,3175,74768
08/03/2015,44922,17931,113,7840,3140,73946
15/03/2015,45244,17426,110,7722,3112,73614
23/03/2015,49297,18152,114,7795,2772,78130
31/03/2015,49215,17844,114,7751,2757,77681
08/04/2015,49084,17907,116,7792,2771,77670
15/04/2015,49115,17796,114,7712,2743,77480
23/04/2015,48984,17796,114,7763,2756,77413
30/04/2015,48718,18318,113,7902,2792,77843
08/05/2015,48605,18332,114,7901,2767,77719
15/05/2015,48781,18677,117,7956,2786,78317
23/05/2015,48363,18102,115,7905,2768,77253
29/05/2015,48533,18073,114,7813,2736,77269
08/06/2015,46306,17940,112,7846,2748,74952
15/06/2015,46527,17993,113,7891,2763,75287
23/06/2015,46996,17955,113,7908,2732,75704
30/06/2015,47376,18254,112,7902,2751,76395
08/07/2015,47606,18141,111,7842,2730,76430
15/07/2015,47390,18110,110,7853,2733,76196
23/07/2015,47718,18042,105,7844,2730,76439
31/07/2015,48211,18100,105,7837,2728,76981
07/08/2015,48074,18254,105,7846,2721,77000
14/08/2015,47892,18487,107,7916,2745,77147
23/08/2015,48104,18885,111,7955,2759,77814
31/08/2015,48429,18654,109,7916,2745,77853
08/09/2015,48253,18991,108,7914,2706,77972
15/09/2015,47756,19142,106,7954,2720,77678
23/09/2015,47908,19257,108,7910,2705,77888
30/09/2015,48105,19538,107,7916,2770,78436
08/10/2015,48404,19888,109,8011,2780,79192
15/10/2015,48477,20189,114,8061,2769,79610
23/10/2015,48286,19634,111,7962,2735,78728
30/10/2015,48410,19963,110,7942,2728,79153
08/11/2015,47791,19426,104,7888,2709,77918
15/11/2015,47903,19669,104,7869,2703,78248
23/11/2015,47753,19935,103,7821,2686,78298
30/11/2015,47652,19977,102,7801,2680,78212
08/12/2015,47517,20527,83,7869,2703,78699
15/12/2015,47884,20876,74,7925,2722,79481
23/12/2015,48239,20973,59,7911,2723,79905
31/12/2015,48229,20848,58,7899,2719,79753
08/01/2016,48497,21124,54,7891,2716,80282
15/01/2016,48886,21670,46,7887,2715,81204
23/01/2016,48921,21589,34,7862,2706,81112
29/01/2016,48678,21902,24,7869,2709,81182
08/02/2016,48659,23287,19,7948,2736,82649
15/02/2016,48764,23352,1,6378,2655,81150
23/02/2016,48398,22694,0,7921,2491,81504
29/02/2016,48617,22472,0,7874,2327,81290
08/03/2016,48423,22772,0,7929,2343,81467
15/03/2016,48119,22759,0,7945,2348,81171
23/03/2016,48356,22795,0,7970,2355,81476
31/03/2016,48501,23301,0,8032,2358,82192
08/04/2016,48562,23311,0,8028,2357,82258
15/04/2016,48659,23140,0,8013,2352,82164
23/04/2016,49361,23074,0,8013,2353,82801
29/04/2016,49816,23654,0,8080,2372,83922
08/05/2016,50087,23636,0,8080,2372,84175
15/05/2016,50586,23647,0,8043,2361,84637
23/05/2016,50272,23874,0,8014,2353,84513
31/05/2016,50214,23746,0,7990,2348,84298
08/06/2016,50239,22893,0,8064,2349,83545
15/06/2016,50512,22648,0,8009,2333,83502
23/06/2016,50514,22910,0,8098,2359,83881
30/06/2016,51116,22187,0,7897,2321,83521
08/07/2016,50875,22013,0,7862,2311,83061
15/07/2016,50452,22052,0,7869,2313,82686
23/07/2016,50892,21441,0,7822,2299,82454
29/07/2016,50864,21879,0,7849,2312,82904
08/08/2016,51096,21682,0,7842,2310,82930
15/08/2016,51681,21803,0,7862,2315,83661
23/08/2016,51818,22082,0,7923,2334,84157
31/08/2016,51766,21822,0,7855,2313,83756
08/09/2016,51957,21979,0,7915,2331,84182
15/09/2016,51799,21870,0,7888,2314,83871
23/09/2016,51697,21716,0,7880,2311,83604
30/09/2016,52301,21726,0,7862,2306,84195
08/10/2016,52527,21318,0,7808,2290,83943
15/10/2016,52419,20832,0,7766,2278,83295
23/10/2016,52405,20671,0,7735,2269,83080
31/10/2016,52682,20696,0,7735,2270,83383
08/11/2016,53525,20802,0,7767,2279,84373
15/11/2016,52882,20335,0,7678,2253,83148
23/11/2016,52880,20059,0,7631,2206,82776
30/11/2016,53110,20181,0,7633,2206,83130
08/12/2016,53111,20373,0,7674,2218,83376
15/12/2016,52553,19985,0,7553,2183,82274
23/12/2016,52372,20217,0,7552,2183,82324
30/12/2016,52496,20453,0,7578,2191,82718
08/01/2017,52787,20317,0,7609,2199,82912
15/01/2017,53489,20591,0,7617,2184,83881
23/01/2017,53609,21271,0,7656,2195,84731
31/01/2017,53257,21670,0,7660,2196,84783
08/02/2017,53375,22110,0,7644,2192,85321
15/02/2017,50251,22071,0,7611,2158,82091
23/02/2017,49782,22417,0,7618,2160,81977
28/02/2017,49879,22415,0,7633,2164,82091
08/03/2017,49628,22320,0,7593,2153,81694
15/03/2017,49780,22906,0,7609,2158,82453
23/03/2017,49700,23668,0,7680,2178,83226
31/03/2017,49040,23691,0,7654,2169,82554
08/04/2017,49637,23566,0,7642,2167,83012
15/04/2017,49818,23730,0,7659,2172,83379
23/04/2017,49797,23868,0,7685,2179,83529
28/04/2017,50377,24412,0,7729,2192,84710
08/05/2017,50515,24374,0,7725,2190,84804
15/05/2017,50632,24428,0,7724,2190,84974
23/05/2017,49537,24998,0,7796,2211,84542
31/05/2017,50478,25098,0,7801,2212,85589
08/06/2017,49716,24893,0,7763,2216,84588
15/06/2017,49746,24648,0,7740,2209,84343
23/06/2017,49670,24703,0,7725,2204,84302
30/06/2017,49644,24990,0,7791,2201,84626
08/07/2017,49460,24818,0,7777,2197,84252
14/07/2017,49497,25072,0,7786,2185,84540
23/07/2017,49509,25033,0,7850,2203,84595
31/07/2017,49506,25362,0,7867,2213,84948
08/08/2017,49443,25184,0,7885,2225,84737
15/08/2017,49547,25137,0,7868,2167,84719
23/08/2017,49575,25023,0,7880,2171,84649
31/08/2017,49794,25231,0,7901,2177,85103
08/09/2017,49704,25603,0,7997,2203,85507
15/09/2017,49504,25458,0,7959,2193,85114
23/09/2017,49520,25225,0,7953,2191,84889
29/09/2017,49287,24975,0,7900,2177,84339
08/10/2017,48884,24659,0,7859,2165,83567
15/10/2017,48953,24943,0,7908,2169,83973
23/10/2017,48623,24777,0,7868,2158,83426
31/10/2017,48714,24701,0,7851,2121,83387
08/11/2017,49130,24610,0,7836,2116,83692
15/11/2017,51907,24854,0,7897,2133,86791
23/11/2017,51793,25042,0,7885,2130,86850
30/11/2017,51583,25174,0,7911,2137,86805
08/12/2017,51571,24958,0,7883,2100,86512
15/12/2017,51609,24900,0,7884,1985,86378
23/12/2017,51247,24996,0,7894,1987,86124
29/12/2017,51343,25308,0,7975,1999,86625
08/01/2018,51184,25274,0,7975,1999,86432
15/01/2018,51088,25785,0,8024,2064,86961
23/01/2018,50659,25605,0,8075,2077,86416
31/01/2018,50615,25889,0,8160,2084,86748
08/02/2018,50353,25467,0,8088,2066,85974
15/02/2018,50256,26200,0,8170,2086,86712
23/02/2018,50298,25935,0,8160,2074,86467
28/02/2018,50589,25695,0,8134,2068,86486
08/03/2018,50772,25880,0,8174,2072,86898
15/03/2018,51586,25434,0,8175,2073,87268
23/03/2018,47374,25664,0,8188,2076,83302
29/03/2018,47477,25568,0,8177,2073,83295
08/04/2018,47639,25550,0,8146,2065,83400
15/04/2018,47522,25674,0,8182,2074,83452
23/04/2018,46876,25079,0,8138,2063,82156
30/04/2018,47211,24874,0,8090,2046,82221
08/05/2018,47202,24457,0,8027,2030,81716
15/05/2018,47053,24331,0,8036,2032,81452
23/05/2018,46796,23854,0,7979,2017,80646
31/05/2018,46821,23970,0,7971,2015,80777
08/06/2018,46841,23998,0,7984,2019,80842
15/06/2018,47053,23722,0,7938,2007,80720
23/06/2018,47168,23863,0,7940,2407,81378
29/06/2018,47589,23864,0,7913,2399,81765
08/07/2018,47713,24004,0,7928,2404,82049
15/07/2018,47851,23880,0,7887,2391,82009
23/07/2018,47814,23305,0,7949,2374,81442
31/07/2018,48232,23268,0,7943,2374,81817
08/08/2018,48363,23047,0,7899,2361,81670
15/08/2018,48655,22682,0,7825,2337,81499
23/08/2018,48462,22604,0,7901,2360,81327
31/08/2018,48173,22771,0,7926,2368,81238
08/09/2018,47791,22656,0,7919,2365,80731
15/09/2018,48035,22786,0,7934,2370,81125
23/09/2018,47781,22913,0,7948,2374,81016
28/09/2018,47752,22682,0,7892,2357,80683
08/10/2018,48089,22540,0,7917,2350,80896
15/10/2018,48185,22722,0,7955,2362,81224
23/10/2018,48448,22991,0,7911,2349,81699
31/10/2018,48930,22812,0,7866,2480,82088
08/11/2018,48961,23188,0,7900,2491,82540
15/11/2018,48771,23467,0,7867,2479,82584
23/11/2018,48057,23744,0,7889,2487,82177
30/11/2018,47932,23703,0,7891,2482,82008
08/12/2018,48778,23869,0,7905,2486,83038
15/12/2018,49350,23818,0,7867,2389,83424
23/12/2018,48893,23928,0,7921,2699,83441
31/12/2018,49090,24189,0,7941,2706,83926
08/01/2019,49127,24161,0,7956,2674,83918
15/01/2019,48796,24174,0,8246,2677,83893
23/01/2019,49022,24054,0,8227,2671,83974
31/01/2019,52450,24458,0,8277,2687,87872
08/02/2019,52322,24233,0,8218,2658,87431
15/02/2019,52194,24143,0,8199,2650,87186
23/02/2019,51989,24277,0,8229,2660,87155
28/02/2019,49023,24459,0,8266,2672,84420
08/03/2019,49180,24212,0,8200,2650,84242
15/03/2019,49567,24467,0,8233,2661,84928
23/03/2019,49023,24480,0,8229,2660,84392
29/03/2019,48271,24268,0,8209,2653,83401
08/04/2019,48148,24389,0,8205,2652,83394
15/04/2019,47810,24392,0,8222,2976,83400
23/04/2019,48834,23952,0,8203,2969,83958
30/04/2019,49362,24040,0,8464,2966,84832
08/05/2019,49637,24056,0,8462,2965,85120
15/05/2019,49860,24026,0,8443,2958,85287
23/05/2019,50096,23942,0,8414,2946,85398
31/05/2019,50394,24009,0,8353,2948,85704
08/06/2019,50502,24329,0,8389,2905,86125
15/06/2019,50350,24060,0,8388,2904,85702
23/06/2019,50308,24512,0,8436,2913,86169
28/06/2019,50205,24722,0,8454,2919,86300
08/07/2019,50329,24488,0,8399,2900,86116
15/07/2019,50459,24625,0,8405,2907,86396
23/07/2019,50214,23716,0,8371,3054,85355
31/07/2019,50189,23579,0,8344,3148,85260
08/08/2019,50593,23945,0,8348,3149,86035
15/08/2019,50625,23922,0,8345,3145,86037
23/08/2019,50262,24249,0,8318,3135,85964
30/08/2019,50478,24230,0,8308,3132,86148
08/09/2019,50352,24293,0,8312,3133,86090
15/09/2019,49738,24236,0,8337,3143,85454
23/09/2019,49923,24372,0,8304,3130,85729
30/09/2019,49662,24179,0,8277,3120,85238
08/10/2019,49533,24430,0,8295,3127,85385
15/10/2019,48848,24627,0,8323,3137,84935
23/10/2019,49036,24393,0,8356,3149,84934
31/10/2019,49425,24558,0,8375,3157,85515
08/11/2019,48877,24155,0,8495,3143,84670
15/11/2019,49016,24545,0,8507,3146,85214
23/11/2019,48977,24464,0,8512,3147,85100
29/11/2019,48941,24480,0,8498,3094,85013
08/12/2019,48805,24507,0,8534,3107,84953
15/12/2019,48923,24920,0,8535,3119,85497
23/12/2019,48626,24655,0,8488,3143,84912
31/12/2019,48646,24967,0,8527,3157,85297
08/01/2020,48563,24894,0,8519,3154,85130
15/01/2020,48633,23072,0,8518,3154,83377
23/01/2020,51380,22971,0,8507,3150,86008
31/01/2020,51908,22929,0,8491,3144,86472
08/02/2020,52026,22707,0,8454,3104,86291
15/02/2020,52006,22796,0,8438,3097,86337
23/02/2020,51964,22851,0,8407,3085,86307
28/02/2020,52755,23240,0,8463,3110,87568
08/03/2020,53240,23948,0,8581,3153,88922
15/03/2020,52549,23043,0,8493,3121,87206
23/03/2020,51766,21947,0,8294,3048,85055
31/03/2020,51886,22724,0,8410,3080,86100
08/04/2020,52584,22402,0,8394,3238,86618
15/04/2020,52696,22673,0,8422,3248,87039
23/04/2020,52320,22399,0,8345,3367,86431
30/04/2020,52701,22850,0,8387,3384,87322
08/05/2020,53488,22635,0,8371,3642,88136
15/05/2020,53333,22459,0,8347,3698,87837
23/05/2020,52172,22690,0,8387,3716,86965
29/05/2020,52199,23016,0,8424,3733,87372
08/06/2020,51330,23467,0,8559,3824,87180
15/06/2020,52079,23612,0,8557,3823,88071
23/06/2020,51242,23714,0,8571,3829,87356
30/06/2020,51047,23649,0,8534,4047,87277
08/07/2020,51626,24010,0,8575,4066,88277
15/07/2020,51978,24225,0,8626,4104,88933
23/07/2020,52043,24859,0,8661,4115,89678
31/07/2020,52027,25442,0,8766,4165,90400
08/08/2020,52266,25408,0,8753,4159,90586
15/08/2020,52056,25508,0,8746,4155,90465
23/08/2020,51198,25545,0,8758,4161,89662
31/08/2020,51001,25908,0,8803,4183,89895
08/09/2020,51258,25826,0,8759,4161,90004
15/09/2020,50506,25874,0,8789,4149,89318
23/09/2020,50879,25672,0,8734,4123,89408
30/09/2020,51347,25969,0,8719,4122,90157
08/10/2020,51227,26208,0,8743,4346,90524
15/10/2020,50870,26106,0,8743,4346,90065
23/10/2020,50447,26670,0,8793,4371,90281
30/10/2020,51276,26506,0,8744,4346,90872
08/11/2020,51203,27072,0,8822,4385,91482
15/11/2020,51193,27043,0,8795,4371,91402
23/11/2020,51413,27080,0,8844,4395,91732
30/11/2020,51179,27301,0,8859,4403,91742
08/12/2020,50615,27604,0,8893,4563,91675
15/12/2020,50141,27529,0,8872,4571,91113
23/12/2020,49304,27408,0,8886,4722,90320
31/12/2020,49236,27584,0,8886,4722,90428
08/01/2021,49384,27323,0,8807,4667,90181
15/01/2021,49164,26734,0,8778,4652,89328
22/01/2021,48846,26747,0,8791,4659,89043
23/01/2021,48846,26747,0,8791,4659,89043
29/01/2021,49007,26666,0,8781,4653,89107
08/02/2021,48917,26475,0,8750,4637,88779
15/02/2021,48750,26619,0,8769,4653,88791
23/02/2021,47159,26519,0,8789,4663,87130
26/02/2021,46707,26210,0,8760,4648,86325
08/03/2021,45661,25783,0,8676,4603,84723
